+--------+
| P      |
|        |
|z P p P |
+--------+
