DIMENSIONS 20 20
ITERATIONS 200
+------------------+
|                   | 
|  z                | 
|                   | 
|                  z| 
|                   | 
|                   |z
|                   | 
|                   | 
|                   | 
|             z     | 
|                   | 
|                   | 
|  p               p| 
|                   | 
|          pz      p| 
|  p              p | 
|                   | 
|                   | 
+------------------+
