DIMENSIONS 10 40
ITERATIONS 200
+--------------------------------------+
|                                      |
|               p                p     |
|                        p             |
| z           z p               p      |
|  p                                   |
|                 z     zz             |
|               z    z                 |
|                                      |
+--------------------------------------+
